GGGGGGGGGGGGTGGBGTTGGBGGBGGGTGGBGGGTGGGGTGGTGGGBGGGGGBTTGGBGGGGGBGGGGGBRGBBGGBBGGGGGGGGGGGGGGGGGRGGG
GGGGGGTGGGTGGGGGGGGGGGRGBGGGGGGGBRGBGGGGBBTTTGGGBGGGTGGGGGGBGGGGGGGGBGGGGTGGGGGGGGGGGBGGGGGGGGGGGGGG
GTTGGGGGGGGGGBGGGGTGGGGGGGBGGGGGGGBGGGGGGGGGGRGGGTGGGTGGGGGGTGGGGGGGGGTGGGGGRTTGGGTTGGGGGGGTGBGGGGGT
GGGGGGGGGGRGGGBGGGGGTGBBGBBGGGGGGGGBGGGGGBGGGRGTGGTGGGGTGGGGGGGRBGGGGGGGGGGGGRGGGGGRTGBTGGGTGGGGGGBG
GGGGGTGTGGGGGBGGGGGGGGGGGRGTGGGGGGTGBGGTGGBGGGGGBGBGGTGGGGGGGGGTGGGGGGGGGGGTTTBGGGGGTGGGGGGGGGGGGGTG
RGGGGGTGGGGGTGGGGTGGGBGGGGTBGGBGGGGTGTGGBGGGGGGGGGTGGGGGGGGGGGGGBGGTGGBGTGGGGGGGGGGGGGGGGGGGGGGGGGGG
GGGGGGGGGGBTGGGGRGGGTGGGGGRGGGGGRGBGTTGGGTGGGBGGGGTGGTGGGRGRGGGGGGGGGGTGRGGBBGGGGGGGGGGGBGBGGGGGGGGG
GGGGGGGBGGBGGGTGTGGTGGBGGBGGGGGGGGBGGGGGGGGGGGGGGGGGGTTGGGGBGGGGGGTGGGBGGGGGGGRGBGGGGGGGGTGGGGBGGGTG
GGGGGGBGGGGGTGGGGGGGGGGGTGGGGGGGBGGGGGGGGGGGGGGGGGGGGGTRTGGGGGGGGGRGGGGGGGGGGGGGRRGTGGGGGGGBGGGGGGGG
BGGGGGGGGGGGGGRGBGGTGGGGGGGGGGGTGGGGGGGGGGGGTGGGGBGGGGGGGGGGGGGTTGGGGGGGGBGBGGGGGGGGGGGGGGGTGTGGGGGG
GTGGGGGGGGGGGGGGGGBGTGGGGGGBGGGBGBBGGGGGGBGGGTGGGGGTGRGGGGGTGBGGTGGGGGGTGGGGRGGBGGGGGGGGGGGGGGGGGGGG
GGGGGGGGGGRGGTGTGGGGGGTGGGGGGGGGTGGGGGBBBGGBGGGGGGGBTGGGGGTTGBGGGGGGGTGGGGGGGTGGGGGTGGBGGGGTGGGTGGGG
GGGGGBGGTGGGGGBGGGGGGGGTGGGGGGTGGGGGBGGGBGGGGGGGTGRGGGGGGGGGGGTGGGGGGGTGTGGGGBGGGTBBGGGGBGGGGGGGGBGG
GGGGTGTGGGGGBTGGGGGGGGGGGTGGGTGGGGGGGGGGGGGGBGGGRBGBTGGGGGGBGGGGGGGGGRGGGGBGGTGGGGGGGGRGGGGGRGGGGTGG
TGGTGGGGGGGGGTGGGBGGGTGGGGGGGBGGGGGGTGGGGGGBGGBGGGRTBGGRGGGGGGGGGGGGGGGGGGTTTGGTGGRGGTGGGGGGGGGGGGGG
GTGGGGGGGGRGBGBGGGGGGGTGGGGGGGGGGGGGBGGGGGGGGGGGGGGGBGGGGGGGGGGTGBGGGGGGGGGGRGGBGTBGGGGGGGGGGGGGGGGG
GGRBGGGGTTBGGGGGGGTGGGGGGBGGGGGGGGTBGGGGGGGGGRGGGGGGGGGGGGGGGGGGGGBGGGGGGGGGGGGGGGGGBGGGGGGGGGGGGGGG
GGGGBTGGGGGGGGGGRTGGGBGGGGGBGTBGGGBGGGGGGGGGGGRGGGGBGGGGTGGGTGGGTTGTBGGGGGGGGGGGGGBGBTGGGGGGGRGGGRGG
GGGGGGGGTGGTGGGGGGGTGRGGTBGGGGTGGBGGTGTGGGGGGBGGGGTGGGGGGGGGGGGGGGGGGBGGGGGGGTGGGGGGGGGGGGGGGGGGGGRG
BBRGGGTGGGGGGGGGBGGGGBBGGGGGGGGGRGGBRGGGGGBGGGGGGGGGGGBGGGGGGGGGGTBGGGGTGBGGBGGTTGGGGTGGGGGGGGGGGTGT
GGGBBGGGGTGBGTGGGGGGGGGGGGGRTGGGTGGGGGGGTGGTGGGBGGGGGGGRGGGGGTGGGGRGGBGGGGGBGGGGGGGGGGTBBGGGGGGGTGGG
GGTGGGRBGGGGGGBGGGRGGGGGGGGGGGGGGRGGGBGRGGBGGTBGGBGGGGGGGGGGGGGGGGGGBGGGGGGBGGGGGGGGGGGGGGGGGGGGTTGG
GGGTGGGGBGTGGGGGTGGTGGGRGGGGGGGGTGGGGGGGGBRGBGGGBGGGRGGGGGGGGGTGRGGGGRGGGGGBGGGGGGGGGGGGGGBGGGGTGBGG
GGGGBGGGGGGGGGGGGGGBBGTGRTGGGGGGRTGGGGGGGGGGGGBTGGGGGGGBGGGGTGBGGGGGGGGGBGGGGGGGBGTGGGBGGGTGGGTGRGGG
GGGGGGGGGGGGGGBGGBGGTTGGTTGGGGGGGGGGGGGBTGGGGGGGGGGGGGGBGGGRTGGGGBTGGGGGGGGGGGGBGGGGGRTGGGBGGGGTGGTG
GGGGGGGGGGGGGGGBGGTGGGGGGBBRGGGGGGGGGGGBGGBGRGRGGGGGGGGGGGTGGGGGGBGGGRGGGGTGGGGGGGGGGGGGGGGGBGRGGGTG
GGTGGGBTGGGGGTGGRGGGGBGTGGBGGTGBGGGGGGGGGBBGGBGGGGGGGGGGGGGGGGTGTGTTGGGGGGGGGGGGGGGGGGGBGGGGGBGGGGGT
GGGBGBGRGGGGBGGGGGGGGGGGGGGGGGBGGGGGTGGGGGGGGGGGGTGGGTGGGGGGGBTGGGGGGGGBGGGGGGGGBGGGGGGTGGGGGGGGTGGG
GGGGGGGGGGGGGGGGGGRGBGGGGGBBGGGGGGTGGTRTGGTGGGGGGGTGTRGGGGGGGGGBGGGGGGBGBGGGGGGGGGBTBTTGBGGGGGGGBGGT
GGTGGGGGGGRBTGBGGTGGGGGGGGGGGBTGGGGGGGGGGGGGGGGRGTBGGGBGGGGGGGGGGGBGBGRGTGGTGGGGGGTGGGGGGGGGGGGGGGGG
GRGGGBGGGGGGGGGGGGGGGGGGGGGGGGGGGGGGGGGGGGGGGGGGGGTGGGGGGGTGGGGGGGGGGGGTGGBGGGTGGGGGGGGGGGGGGGTGBGGG
GGGGGGGGGGGTGRBGGTGGGTGGBGTGGGGGGGGGBGGGGGGGGGGTTGGGGGGGGGGBBGGGGGGGGGGGGGGGGBGGGTGGGGGGGGTGGGGGRGGG
GGGGGTGGTGGBGGGGGRGTGGGGTBGGTTTTGGTGGGGGGRGGGBGTGBGGGGGRGTGTGGGGTGRTGBGGGGGGTGGGGGGBGGGGGGGGGGGGGGGG
GGRGGGGGBGGGGGGGGGGBGGBBTGGGGGTTTGGGGGRGGTGGGBTGGGGGGGGBGGRGGBGGBTBGGGGGTGGGGGGGGGRGGGGGTGGGGGGGTGGT
RGGGGGGGGTGGGGGGGGBRGBGGTGGGGGGGGGGTGGGGGRBGGBTGGGGGGTGGGGBGRGBBTGGGGGGGGGGGGGTGGGBGGGGGGTBGGGGGGBGT
GTGGGGGGGGBGTGGGTGBGGTGGGGBBGBGGGBGGGGTGGRGGGGGGGGGGTGGGGGGGRGTGGTGGGGGBTGGGGBGGGGGGGTGGGGTGBGGGGGGG
GBGGGGGGGGGGGTGGBGGGGGGGGTGGTGRGGGTGGBTBGTGGGGGGGGTGTGGGGGGBGGGGGGGGGGGGGGBTGGGGGGTGTGGGGGGGGGTGGGGT
GGGGGGGGGGGGGBGGGGBGGGGGGGGGGGGGGGGTGGGGGGGGGGGTGGGGGGGGGGBGGGGGGGGGGGGTTGGGGTGGGGGGGGGGTGTGGBTGRGGG
GGGTGGGGGGTGGGBGGRBGGGGTGGGGGGGGGGTGTTGGGGTGGGGGGGGGTGTTGTGGGGGGGBGGGGGGTTGRGGTGBTBTGGTGGGGGGGGGGGTG
GGTGGGBGGGTGGGGGBGGGBGBGGGGGTRGGGGGGGGGGGGGGGTGBGGGRGGGGGGGGGGGBGGGGGGGGGGGTGGTGGGGGTGGGGGGGRGGGGGGG
GGGGGGGGGGGGTGBGGGGTTGGGGGBGGGGTGGGGGGGGGGTTGBBGGBGTGGGGBGGGGGGGGGGGGGGGGGGGGGGGGTGGGGGGGGTGGGGGGGGG
GGGGGGGGGGGGGGTGGGTTGGGGGGGGGGGBGGGGGGGGGTGGTTGGGRGGTGRBGGGGGGGGTGGGGGGGGGGGGGGGBGGGBGGGGGGGGGGGTGGG
BGTGGGTGTGGGGGGGGRGGGGGGGGBGGGGGGGTGGGGRGGGGGGBGRGBGGGGGGGGGGGTBGGGTGGGTGGGGGBGGGGGGGGGGGGGGGGGGGGTG
GGGGGGGGGGGGGGBGGGGGRGRGGGGGGGGBGGGTBGTGGGGGGGGGGGGGTGGGGTGGGGBBBGGGGGTGTGGGGBGGGGGGGGGGGGGGGGGGGRGG
GGGGGBGRTTTGGGTGGGGBGGGRGGGGGGGGBGGGGGGGTGGGGGGTGTGGGGGGGGGGGGGBTGGGGGGGGGGGBRTGGGTBTGGGGTGGGGGGBGGB
GGGGGGGGGTGGGGTGGGGGGBGGGGGTGGGGGGGBGGTBGGGRGGGGGGGGRTGGGGGGGGGGGBTGGGGTGGGGGGGGRGGGTGGGGGTGGGGGGGGG
GGGGGGGGBTGGGGGGGTGTGGGGGTGGGGGGGGGTGGBGGGTGGGGGGGGGGGGGGGGGGGGGGGGGGGGGGGGGGBGTGGGGTGTGGGGTGRGGGTGG
GGTGGGTGGGGGGGRGGGGGGGGGGGGGTGGGTGGGGGGGGRGGGGGGGRGGGTGGTTGGGGGGGGGGGGGGBGGGGTGGGGRTGGGGGGTGGGGGGGBG
GGGGGGRGGGGGBGGGGGGGGGGGGTBGGGGBGTGGGGTRBGGGGGGGTTGGGGGGTGGGTGGGGGGGGGGGGGGGGGGGGGGGBGGGGGRGGGGGGGGR
GGGGGTRGRGGTGGGGGGGGGGGGGGGGGTGTGGGBGGGRGGGGGGGGGGGTTGGGGGGBGGGTRGBGGGGGRGTRGGGGGTGTGGGGGGGGGGBGGGGG
TGGGGGGGGGGTGGTGGGTGGGGGGGGGGGTGGGGGGGGGGGRGBGGTGGSTGGGTGGGGGGGTGGRGGGGGGGGGGGTGGGGGBGGTGGGGGGGGGGGG
BGGGGGTGGGGBTBGGTGTGGTTBGGTGGGBBGGGGGRGGGRGGGGGGGGGGBGGGGGGGGGGGGGGGGTGGGGGGBTGGTTGGGBGTGGGGGGRGGGGG
GGGGRGGGRBGGGGGGTGTGTGGGGGGGGRGGGGGGTGGGGGGGGBGGGGGBGGGGTGGGGGGBGGGGGGGBBGGGGBGGGGGTGGTGGGGGTTGGBGGG
GGGGRGGRGBGGGGGBGGBGBGGTGGGGGGGGGGGGGGGGGGTGGGGGGGGGGGGGGTGGGGGTGGGGTGGGBTGGGGGGGTGGGBGGGGGTTGGGGGGT
GGTGTGGGTGGGGGGGGGGGGTGGGGGTGGGGGGGGGGGRTGGGGGGGGGGGGGTGGGTRBRGGGRTGGGGGGTGGGTGGGGGTGGGTGGGRTGGGGBRG
GGTGGGGTGGGGRGBTGTGGGGGRGGBGGGTGGGGGGGTGGTGGGGGGGGGGGBGTGGGRGGGGGBGGGTGGGRGGTTGBGRGGGGGTGGGGGGGGGGBG
GGGGGTGGGGGGTBGGGGGTGGGBGGGGGGGGGGGTGGTGGGGGBRGGGTGBGGBGGGGBBGGGGGGGGGGGGGGTGGBGBGGGGGGGGGGGGTGGGGBG
GGGGGGGGGGGTTGGGGGGGGGGGGGGGTGGGGGGGGGGGGGTGGGGGGTGRGGGGRGGTGGGBGGGGGGBGGGGGTGGGTGRGGTBGGGBTGGGTGGGG
TGTGGBGGGBBGGGGGBGGGGGGGBGGBGTGGGGGBGGGGGGGGGGGTGGGGGGGGGGGGGGGGGTGGTGGGGGGTTGRGGGGGGGGGGGGTTGGGGGGG
GGGGGGTRGGBGTGGGGGRBGGGGGGGGGGRGTTTGGGGGGGGBGGGGGGGGGGGGTGGTGBGGGGGGGGGGGGGGGBGGGGGGGGGGGGGGGGGTGGGG
GGRGGGGGGGGGGBGGGGGGGGGGGGRGBRGBGGGGGGGGGTGBGGBGGGGGGBGGGGTGTGGGGGBGGBGRGGGTGGBBGGGTGGTGGGGGGBGGGBGG
GBGTGTGGGGGGGGBGGGGGGGGGGGTGBTGGGGGGGGGGGGGGGGGGGGRGGTGGGGGGGGGGGGBRBTGGGBGGGGGGRGTGGGGGGGGGGBTGGGGG
GGTGGGGGGGGGGGGGGGTGGGGGBGRGGGGGGGGBGGGGGGBGGGGGGGGTGGGGGGBGGRGTGGGGGGGGGTGGGGGGRGGGGGGGGGGGGGGGGGGB
BGTBTGGGGTGGGGGGGGGGGGGGGGGGGGGRGGGGGTGGGGGTGGGTGGGGGGGTGGGGGGGGGGGTGGGGGGGGGGGGGGTGGGGGGGGGGTGGGGGG
GBGGGBGGGGGGBGTTGGGTTTGRGGGGGGGGGGGGGGGGGGGGBGBRTGBGGGBBGTGGBGGGGGGGGGGRGGGGTGTGGGGGTGGGGGGGGGGGGGGG
GBGGGGGGTGGGTGGGGGGGBGGTGGGGGGGGGGGBGGGTGGTGGGGGTGGGGGGGGGGGGGGGBGGRTGGGTGGGGGGGBGGGGTBGGGGGGGGGBGGG
GGGGGTGGGGGGGGGGGGTGGGGBTBGTRGGGGGGGGGTGGTGGGGGGGGGGTGBGGGGGGGGGTGGGGGGGGGGGGBGGGGGGGGGTGGGGRGGGGGGG
GGGTBGTBGGGGGBGRGGGGTGGGGGGGGRGGGGGRGGGGGBGGGGGGGTGGGGGGGGGBGGGGGRGGGGGGGTGGTGGGGGGGBGGBGTGGGGGRGGGG
GGGGGGRTGGGGGGGGTGGGGGBGGRGGGTBBGBBGGGGGGTGGGBGGGGGGRGGGGGBGGGGGGGGGRGGGGTBGBGGGGGGGRGGGGGGBRGGGGGGG
GGGGGGGTBGGGGBGGGBGGGGGGGGTTGGGGGGGGGGGGGGGGGGGGTGGGGGGGGGGGGGBGGGTTGGGGRGGGGGTGGGGGGGGGGGGGGGGGTGGG
GRGGTGGGTGTGGGGGGGGTBTGGGGGGTBGTGTGGGGGGTGGGGGGGGGGGGRGGTGGGGGGGGGGGGTBGRGRGGGGTTGGGGRGGGGTGGGGGGGGG
GTGGGGGGGGGBRGTGBGTGGGGTGGTGRGGGGRGTGGGGGGBBGGTGGGGGGGGRGGGGGGGGTGGRGGGGGRGBBGGBGGGGGGGGGBGGGGTGGGGG
GGRTGGGGGGGGGGTTGGTGGGGGGGGGGTGGGTGGGGGGGGGGTRGGTRGGTGGGGRGGGGGGGGTBGGGGBBGBGGGGGRGGGGGGGTGGGGGGGGGT
GGGBGGGGGGGGGGTGGGGGGGTGGTGGGGBGGBGTGGGTGGGGBGBGGGGGGGGGGGGGTGGGGGGGGGGGTGGGBBGGGBGGTGTGGGTTGGGGGGGT
GTRGRGGGGGGRGGGTGBGGGGGGGGGGGGGBGGGGTGBGGGGBGRGGGGGGGGRGGGGGRGGRGGGGTGGTGGGGGGGGGGBTGRGTGGTGGGGRGGGG
GGGGGGGGGGTGGGGGTGGGGGGGGTGGGGGGGGTGTGGGGGRGGGGGGGGGGGGGGGBGGBGGGGGGGGBGGGRGGTGGGGGTGGGGGGGGBGGGGGGG
GGGGBTGGGGGGGTGGGBTGGGGRGGGGGRGGGRGGGGGGGGGGGGGBGTTGGGBTTGGGGGBGGGTGGGGGGBGGGGGGGGGGGGGGGGGGGGGGGGTG
GGGGTGGGRGRGGGGGGGGGGGTGGBGTGGBGGGGGRGTGGGGGGGGGTGGGGGGGGGGTGGGGGGTGGGGGGGGBGGBGGTTBGGGGGTGGGGGGGGGT
GTGGGGGGGGGGBGGGGGGGGGGGGGGGGRGGGGBBGTGGGGGGGBGBGGGGGTGRGGGGGGGGGGRGGGGGGGGGGGGGGGBGGGGGGGGGGGGGGGGG
GGGTGGGGGGBGBGGGGGGGGGGGGTGGRGGGGGGGGGGGRGGGGGGGGBGGGGGGGGBGGGGGGGGGGGGBGGGTGGGGGGTGGGBGGGGGGGGGGBGG
GGGBGGGTGGBGGBGGGGGGTGGBGBGGGGGBGGBGGGGGGGBGTGRGGBGTGTGTGGGGGGBGGGGGRTGGGGBGGGGGGGGGGGBGGBGGGGGTGTGG
GGGGGGGGGGGGRBGGGBTGGGGGGRGGGGGGRGGGGGGGGGGGGGGTGGGGGGGGRGGGGGGGGGGGGGGGGGTGGBBGGGTGGGRGGGTGGGGGGGGB
GGBGRGGTGGGGGGGGGGGGGRGGGGBGGGGGGGRGGGGGGGGBBGGGGGGGGGBGGGGGGGGBGGBGGGGRGGGTGGGGGGBRGGGGGGGGTRGGGGGG
GGGGGGGGGGBTGGBGGRGTGGGGRGGGGGGTGGGGGGGGGGGGGGTBGRGTTGGGGRGGGGGGGTGTGGGGGGGGGGGGGRGTGGGGGGGGGGGGGGGG
GGGGGGTGBTGGGGGGGGGGGGGGGGGGGGGGGGGGTGTGGGTGGTGBGGGGGBGGGGGGGGGGGGTBGGGGTGGGGGGBGGTGGGGTGGGGTGGGBGGG
GGGGGBGGGGGGGGGGGGGGBTGGRGGGGGGGGGGGGGGGBGTGGGTGGGBGGTGGTGGBGGGTGGGGGBGGGGGGGGRGGGGBGGGTBGTTGGGGGGTR
GGBGGGGGGGGGGGGGGGGGGGGGGGGGGGGGGGBGTGGGGGGBBGGGRGGGGGGTGGGGRGGTGGGGTGGRGGGGGGGGGGGGTGGGGGGGTGGGGGGG
GBBGGGGGTGGGGGGTBGRTGGGGGGGGGGRTGGGGGGBGBTGGRGGGGGGGRGGTGGGGGGGBGGTGGGGGBGGGGGTGGGGGGGGGGGTGGGGTGRGG
GGGTGGGGGBGGGGGGGGGGBGGGGGGGGGGTGGGGGGGGBGGGGGGGGBGGGGGGGGGGGGGGGGGGGGGBGGGBTGGGGGGGGGGGGGGGGGGTGGBR
GGGGGTGBGGGGGGRTGGGGRGGGBRGGTGGGRGGGGGGGBGTRGGGGGTGGGGGGGGGGRGGGGGGGGTGGGGGRGGGGGGGGGGGGTGGGGGGBBGBG
GGGGGGGGGGGGGGGGGGGGGGBGGGRGTBGGGGGGGTGGGGGGGGGGGGGGRGGGGTBGGGGGGGGGGTGGBGGGGGTGGGRTGGBGTGGGGGGGGTGG
GGGGGGTGTBGGGGGGGGGTGGGGGGGGGGGGGGGGGGGBGGGGGBGTGGGGBGGGGGGGGGTTGGGGGGGGGGGGGGTBGGGRGGGGGRGGGGGGGGGG
GGGGGGRGGGGTGGGGGGBGBGGGGGRGGGGGBGGBGGGGGGRGGGGGGGGGTGTGGGGGGGGGTGGGGGGGGRGGGGTGGGGBGBGGGGGGTGBGGBGG
GGGGGGGGGGGGBBGGGGGGGGGGGGGGGGGGGGGGGGGTTGBGGGGGGGGGTTGGRGGTTGGGGGTGBTGGGTGGGGGGGGGGGGGGBGGGGGGTGGGG
GBTGGBGGGGGTTGGBTGGGGTGTRGGGGGGGGGGGGGGGGGGRGGGGGGGGGGGGGGGGBGGGGGGGGGGGGGGGGGGGGGBGTRGGGGGGGGGGTGGT
GGGGGTGGRBGGGGGRGGGTGGBBGGTGGGGGGGGBGGGGGGTGGGGGGBGGGGGGRGGGTBGGGGGGGGGGGGGGGGGGGGGBGTGGGGGGGRGGBGGG
GGGTGGBGGBGGGGBGGGGGGTGGGGGGGGGBGGRGGGGBGGGGGGGGGTGBGTGGGBGGGGGGBBGBGBRGGGGGGTGGGGGGGGGGGGGGGRGGGGGR
GGGGGGGBTGGGTGGGGGGGGGGGTBGGBGGGBGGGBGBGGGGGGGGGGGGTGGGBGBRGTGTRGTGRGGGGGGTGTGGGGGGTGGGGGGGGGGGGGGGG
GGGGGGGGRGTGGGGGGGGGGGGGGGGGTRGGGGGGGGGGGGTGGGGRGGGGBGGGGGGTGTGGTGGGGGTGGGGGBGGGGGGGTRRGTGGGBGGTGGGG
GTGBGGGTGGGGBGGGGRGGBGGBGGGGGGGGBGGGGGGGGGGGGBGGGGGGGTGGTGTGGGGBGTGGGGGGGGTBGRBTGBBGGGTGGBGBGRRGBTGB